111111111111111111111111111111111111
1P000C00000000000000C0000000000000E1
100010010001001000100100100100100101
1C00000001000100001000100010001000C1
100000000000000000000000000000000001
111111111111111111111111111111111111
