1111111111111111
1P0000C0000000C1
1011001100111101
10110C1100001101
10111111C0111101
10000C1100110001
100000110C1111C1
1C0C00000C0000E1
1111111111111111