11111111111111
10P0000E00C001
11111111111111