11111111111111111111111111111111
1P000C000000000000C00000000000E1
10001001000100100100100100100101
1C0000000100010001000100010000C1
10000000100010001000100010000001
10000100100100100100100100100101
10000100100100100100100100100101
10000100100100100100100100100101
1010100B010010010010010010010011
10000100100100100100100100100101
11111111111111111111111111111111
