1111111111111111111111111111111111
1P00000C0000000000000C0000000000E1
1000100100010010010010010010010001
1C000100010001000100010001000100C1
1000000000000000000000000000000001
1000010010010010010010010010010011
1111111111111111111111111111111111
