11111111111111111111111111111111
1P000C0000000000000C0000000000E1
10001001000100100100100100100101
1C0000000100010001000100010000C1
10000000000000000000000000000001
11111111111111111111111111111111
