11111111111111
10010000000C01
10010101110001
1P0001E0000001
11111111111111