1111111111111
10C100C0000C1
101P011111001
100011E000001
1111111111111