1111111111111111111111
10C10C00000CC001001111
10C0011111000100110001
1PC011E0C0010110000001
10C0011111011101110C01
1111111111111111111111