11111111111111
11P0000000C001
10E00000000001
11111111111111