11111111111
1P0000000C1
10000110001
10000000001
1C001000001
10000001001
1000E000001
1000000C0E1
11111111111
