111111111111
1P0000000001
100011100001
1C0000000001
100001000001
1000000C0001
100010000001
100000000001
100P0000C0E1
111111111111
