11111111111
1P000E000C1
11111111111