1111111111
1P000000C1
1000110001
1C00010001
1000010001
1000000C01
1000000001
1111111111
