111111111111
1P0000000001
100011100001
100000000001
100001000001
100000000001
100010000001
1000000000E1
111111111111
