1111111111
1P00000001
1000110001
1C00010001
1000010001
1000C00001
1000100001
10000000011
1000E00C11
1111111111
