1111111111111111111111111111111111
1P00000C0000000T0000C0000T000000E1
1000010010010001001001001000100001
1C000100010001000100010001000100C1
1000T0000T0000C0000T0000C00000T001
1111111111111111111111111111111111
