11111111111111111111111111111111
1P000C000T000000C0000T000000C0E1
10001001000100100100100010010001
1C0000C00010001000100010001000C1
1000T0000T0000C000000T00C0000T01
10000100100100100100100100100101
11111111111111111111111111111111
