111111111111111111111111111111111111
1P000C000000T0000C0000T0000000C000E1
100010010001001001001001000100100101
1C0000C000100010001000100001001000C1
1000T000T00000C00000T000C0000000T001
111111111111111111111111111111111111
