1111111111111111111111111111111111
1ET000000000000C00000C00010T000001
101001010010T0001T10010TT000010101
1010T1001010101000100100010T010101
1P0000000C00C0000000T00T00000000C1
1111111111111111111111111111111111
