11111111111111
10P0001E00C001
100C0C000C0011
11111111111111