1111111111111111
1P00000000000001
1011001100111101
1011001100001101
1011111100111101
1000001100110001
1000001100111101
1C000000000000E1
1111111111111111