11111111111111
11P0000C000001
1000000001EC01
11111111111111