1111111111111111
1P0000C0000000C1
10110011T0111101
10110C1100001101
10111111CT111101
1000TC1100110001
1T0000110C1111C1
1C0C00T0TC0T00E1
1111111111111111