1111111111111111
1P00000000000001
1011001100111101
1011001100001101
1011111100111101
1000T01100110001
10000011T01111T1
1C0000T0T00000E1
1111111111111111