1111111111111111
1P00000T00000001
1011001100111101
1011001100001101
1011111100111101
1000001100110001
1000TT1100111101
1C0T0000000000E1
1111111111111111